###########
#   #*    #
# ##### # #
# #   # # #
# ### # # #
#       # #
# ##### # #
#     # # #
##### ### #
#     #   #
###########